title: Pfeil und Bogen
size: 10

..........
..OO......
..O.O.....
..O..O....
.OO...O...
OOOOOOOOOO
.OO...O...
..O..O....
..O.O.....
..OO......


